1111111111111111111111111111111111
100000000000000C10000C000000000001
1010010100100001101001000000010101
1010010010101010001001010010010101
100000000C01C0000000001011P00000C1
1000000000001000100000010010000001
1000000000100001110000000000010001
10000000000100C0100000000010000001
100000C000001000000000000111111111
1000000000000001000000000100000001
1000000000000000000000C000000E0001
1000000000000000000010000100000011
1111111111111111111111111111111111