111111111111111111111111
10000010000100000000F001
10001010P000000110000001
11111110000100001000E001
100000111111000010000001
111111111111111111111111